NO imgs/wall1.xpm




SO imgs/wall2.xpm


   				EA         imgs/wall4.xpm     	   


	WE          imgs/wall3.xpm       





F 255,    100,0


C 225,255,0



1111111111111111111111111
1000011111111111111111111
1100000001111111111111111
111101100000000001111111
1110001110000000001111111        1111
1000000111111111111111111        1011
1000000111111111111111111        1111
1111011111011100000010001
1111011111101110101001001
1100011010101110W00100001 
1000000000001100000010011
1000100000001001100000111
1111011111101001111010001
1111111111111111111111111
