NO imgs/wall1.xpm

SO imgs/wall2.xpm

WE imgs/wall3.xpm

EA imgs/wall4.xpm

F 220,100,0

C 225,30,0

111111111111111
100000000000101
1000010N0000101
111100000010101
100000000010101
100000001111101
100000000000001
100000000000001
111111000111101
100000000000001
111111111111111
