NO imgs/wall1.xpm
SO imgs/wall2.xpm
WE imgs/wall3.xpm
EA imgs/wall4.xpm
F 220,100,0
C 225,30,0

11111111
10101001
10000101
11110001
10000011
10000011
11011N11
11111111